...###
..##.#.###.
.##..#.#..#
##........#
..@....#..#
.##..###..#
..#..#....#
.##..#.#.##
.#......##
.#.....##
.##..###